1111111111111
10010000000C01
1000011111001
1P0011E000001
1111111111111
11111111111111111111111111
1111111111111
1111111111111
1111111111111
1111111111111
1111111111111
1111111111111
1111111111111
1111111111111
11111111111111111111111111
11111111111111111111111111
1111111111111
1111111111111
1111111111111
1111111111111
1111111111111
1111111111111
1111111111111